###########################
#************#************#
#*####*#####*#*#####*####*#
#*####*#####*#*#####*####*#
#*************************#
#*####*##*#######*##*####*#
#*####*##*#######*##*####*#
#******##****#****##******#
######*##### # #####*######
     #*##         ##*#     
######*## ####### ##*######
     #*   #     #   *#     
######*## ####### ##*######
     #*##         ##*#     
######*## ####### ##*######
#************#************#
#*####*#####*#*#####*####*#
#***##******* *******##***#
###*##*##*#######*##*##*###
###*##*##*#######*##*##*###
#******##****#****##******#
#*##########*#*##########*#
#*************************#
###########################